EA ./textures/ea.xpm
SO ./textures/so.xpm

F 75,255,75
C 208,171,147

NO ./textures/no.xpm
WE ./textures/we.xpm


        1111111111111111111111111111111111111111111111111111111111111111111111111
        1000000000110000000000000000000000000000000000000000000000000000000000001
        1011000001110000010000000000000000000000000000000000000000000000000000001
        1001000000000000000000000000000000000000000000000100000000000000000000001
111111111011000001110000001100000000000111100000000000000000000000000000000000001
100000000011000001110000000000100000000010000000000000000010000000000111111111111
1111011111111101110000000000001000000000111111000000000000100000000000010001
1111011111111101110101001000001000000000100000000000000000100000000000001111
1100000011010101110000001000001000000000000000000000000000100000000000000001
1000000000000000110000001000001000000000000000000000000000100000000000000111
1000000000000000110101001000000000000000000001000000000000000000000000000001
11000001110101011111011110N00000000000000000000000011111111111100000000001111
11110111 1110101 101111010000000000000000000000000000000000000000000000011
11111111 1111111 11111111111111111111111111111111111111111111111111111111
