
F 155,202,243
C 208,171,147

NO ./textures/no.xpm
SO ./textures/so.xpm
WE ./textures/we.xpm
EA ./textures/ea.xpm


1111111111111
1000000000111
1011001001111
10010000N0001
1011001001111
1011001001111
1111111111111

