
F 255,138,130
C 0,233,2 37
NO ./textures/no.xpm                             
SO ./textures/so.xpm
WE ./textures/we.xpm
EA ./textures/ea.xpm

           111     111
1111111111110111111101111
1000000000110000000000001
1011000001110000000000001
100100000000000000000000111111111
111111111011000001110000000000001
100000000011000001110111111111111
11110111111111011100000010001
11110111111111011101010000001
11000000110101011100000000001
10000000000000001100000010001
10000000000000001101010010001
11000001110101011111011110E0111
11110111 1110101 101111010001
11111111 1111111 111111111111